NO textures/simonkraft/MARBFAC2.xpm
WE textures/simonkraft/SKULWALL.xpm
SO textures/simonkraft/MARBFACE.xpm
EA textures/simonkraft/SKULWAL3.xpm

F 0,32,0
C 120,0,16

111111111111111111111111111
1100000111111111000000000111
10000000111111100000000000111
110000011111110000000000000111
 111011111111110000000000000011
  110111111111110000001000000011
   10111111111110000111000000011
   1011111111111000001000000011
   100000000000000000000000011
   10111111111110000000000011
   1011111111111000000000011
  110111111111110000000000111
 11101111    10000000000111
110000011    1000000N000111
100000001    11000000000111
110000011     1100000000111
 11111111      111111111111