11111   1111111111111111
11111     111111111111111
11111111111111111111111111
 1000000000110000000000001
11011000001110000000000001
10010000000000000000000011111111
11111111011000001110000000000001
100000000011000001110111111111111
11110111111111011100000010001
11110111111111011101010010001
11000000110101011100000010001
10000000000000001100000010001
10000000000000001101010010001
110000011101010111011110N0111
11110111 1110101 101111010001
11111111 1111111 111111111111

NO textures/simonkraft/wet_sponge.xpm
SO textures/simonkraft/wet_sponge.xpm
WE textures/simonkraft/wet_sponge.xpm
EA textures/simonkraft/wet_sponge.xpm

F 164,169,20
C 153,204,255
